{
  "contentType": "text/json",
  "transform": {
    "translation": {
      "x": 0,
      "y": 0
    },
		"rotationUnit": "degree",
    "rotation": {
      "z": 0
    },
    "scaling": {
      "x": 1,
      "y": 1
    }
  },
  "material": {
    "diffuse": {
      "r": 255,
      "g": 255,
      "b": 255,
      "a": 255
    }
  },
  "tilemap": {
    "size": {
      "x": 512,
      "y": 224
    },
    "viewOffset": {
      "x": 0,
      "y": 0
    },
    "cellSize": {
      "x": 16,
      "y": 16
    },
    "blitSize": {
      "x": 16,
      "y": 16
    },
    "mapSize": {
      "x": 14,
      "y": 224
    },
    "transpose": true,
    "tiles": [
      [ 0, 0, 0, 0, 0, 0, 0, 0, 0, 0, 0, 16, 50, 50 ],
      [ 0, 0, 0, 0, 0, 0, 0, 0, 0, 0, 16, 17, 50, 50 ],
      [ 0, 0, 0, 0, 0, 0, 0, 0, 0, 1, 17, 19, 50, 50 ],
      [ 0, 0, 0, 0, 0, 0, 0, 0, 0, 0, 18, 17, 50, 50 ],
      [ 0, 0, 0, 0, 0, 0, 0, 0, 0, 0, 0, 18, 50, 50 ],
      [ 0, 0, 0, 0, 0, 0, 0, 0, 0, 0, 0, 0, 50, 50 ],
      [ 0, 0, 0, 0, 0, 0, 0, 0, 0, 0, 0, 0, 50, 50 ],
      [ 0, 0, 0, 0, 0, 0, 0, 0, 0, 0, 0, 0, 50, 50 ],
      [ 0, 0, 5, 21, 0, 0, 0, 0, 0, 0, 0, 0, 50, 50 ],
      [ 0, 0, 6, 22, 0, 0, 0, 0, 0, 0, 0, 0, 50, 50 ],
      [ 0, 0, 7, 23, 0, 0, 0, 0, 0, 0, 0, 0, 50, 50 ],
      [ 0, 0, 0, 0, 0, 0, 0, 0, 0, 0, 0, 2, 50, 50 ],
      [ 0, 0, 0, 0, 0, 0, 0, 0, 0, 0, 0, 3, 50, 50 ],
      [ 0, 0, 0, 0, 0, 0, 0, 0, 0, 0, 0, 3, 50, 50 ],
      [ 0, 0, 0, 0, 0, 0, 0, 0, 0, 0, 0, 3, 50, 50 ],
      [ 0, 0, 0, 0, 0, 0, 0, 0, 0, 0, 0, 4, 50, 50 ],
      [ 0, 0, 0, 0, 0, 0, 0, 0, 35, 0, 0, 16, 50, 50 ],
      [ 0, 0, 0, 0, 0, 0, 0, 0, 0, 0, 1, 17, 50, 50 ],
      [ 0, 0, 0, 0, 0, 0, 0, 0, 0, 0, 0, 18, 50, 50 ],
      [ 0, 5, 21, 0, 0, 0, 0, 0, 0, 0, 0, 0, 50, 50 ],
      [ 0, 6, 22, 0, 0, 0, 0, 0, 33, 0, 0, 0, 50, 50 ],
      [ 0, 7, 23, 0, 0, 0, 0, 0, 35, 0, 0, 0, 50, 50 ],
      [ 0, 0, 0, 0, 35, 0, 0, 0, 33, 0, 0, 0, 50, 50 ],
      [ 0, 0, 0, 0, 0, 0, 0, 0, 35, 0, 0, 2, 50, 50 ],
      [ 0, 0, 0, 0, 0, 0, 0, 0, 33, 0, 0, 3, 50, 50 ],
      [ 0, 0, 0, 0, 0, 0, 0, 0, 0, 0, 0, 4, 50, 50 ],
      [ 0, 0, 0, 0, 0, 0, 0, 0, 0, 0, 0, 0, 50, 50 ],
      [ 0, 0, 5, 21, 0, 0, 0, 0, 0, 0, 0, 0, 50, 50 ],
      [ 0, 0, 6, 22, 0, 0, 0, 0, 0, 0, 36, 52, 50, 50 ],
      [ 0, 0, 6, 22, 0, 0, 0, 0, 0, 0, 37, 53, 50, 50 ],
      [ 0, 0, 6, 22, 0, 0, 0, 0, 0, 0, 0, 0, 50, 50 ],
      [ 0, 0, 7, 23, 0, 0, 0, 0, 0, 0, 0, 0, 50, 50 ],
      [ 0, 0, 0, 0, 0, 0, 0, 0, 0, 0, 0, 0, 50, 50 ],
      [ 0, 0, 0, 0, 0, 0, 0, 0, 0, 0, 0, 0, 50, 50 ],
      [ 0, 0, 0, 0, 0, 0, 0, 0, 0, 0, 0, 0, 50, 50 ],
      [ 0, 0, 0, 0, 0, 0, 0, 0, 0, 0, 0, 0, 50, 50 ],
      [ 0, 5, 21, 0, 0, 0, 0, 0, 0, 0, 0, 0, 50, 50 ],
      [ 0, 6, 22, 0, 0, 0, 0, 0, 0, 0, 0, 0, 50, 50 ],
      [ 0, 6, 22, 0, 0, 0, 0, 0, 0, 36, 52, 52, 50, 50 ],
      [ 0, 7, 23, 0, 0, 0, 0, 0, 0, 37, 53, 53, 50, 50 ],
      [ 0, 0, 0, 0, 0, 0, 0, 0, 0, 0, 0, 0, 50, 50 ],
      [ 0, 0, 0, 0, 0, 0, 0, 0, 0, 0, 0, 2, 50, 50 ],
      [ 0, 0, 0, 0, 0, 0, 0, 0, 0, 0, 0, 3, 50, 50 ],
      [ 0, 0, 0, 0, 0, 0, 0, 0, 0, 0, 0, 3, 50, 50 ],
      [ 0, 0, 0, 0, 0, 0, 0, 0, 0, 0, 0, 4, 50, 50 ],
      [ 0, 0, 0, 0, 0, 0, 0, 0, 0, 0, 0, 0, 50, 50 ],
      [ 0, 0, 0, 0, 0, 0, 0, 0, 36, 52, 52, 52, 50, 50 ],
      [ 0, 0, 0, 0, 0, 0, 0, 0, 37, 53, 53, 53, 50, 50 ],
      [ 0, 0, 0, 0, 0, 0, 0, 0, 0, 0, 0, 16, 50, 50 ],
      [ 0, 0, 0, 0, 0, 0, 0, 0, 0, 0, 16, 17, 50, 50 ],
      [ 0, 0, 0, 0, 0, 0, 0, 0, 0, 1, 17, 19, 50, 50 ],
      [ 0, 0, 0, 0, 0, 0, 0, 0, 0, 0, 18, 17, 50, 50 ],
      [ 0, 0, 0, 0, 0, 0, 0, 0, 0, 0, 0, 18, 50, 50 ],
      [ 0, 0, 0, 0, 0, 0, 0, 0, 0, 0, 0, 0, 50, 50 ],
      [ 0, 0, 0, 0, 0, 0, 0, 0, 0, 0, 0, 0, 50, 50 ],
      [ 0, 0, 0, 0, 0, 0, 0, 0, 0, 0, 0, 0, 50, 50 ],
      [ 0, 0, 5, 21, 0, 0, 0, 0, 0, 0, 0, 0, 50, 50 ],
      [ 0, 0, 6, 22, 0, 0, 0, 0, 36, 52, 52, 52, 50, 50 ],
      [ 0, 0, 7, 23, 0, 0, 0, 0, 37, 53, 53, 53, 50, 50 ],
      [ 0, 0, 0, 0, 0, 0, 0, 0, 0, 0, 0, 2, 50, 50 ],
      [ 0, 0, 0, 0, 0, 0, 0, 0, 0, 0, 0, 3, 50, 50 ],
      [ 0, 0, 0, 0, 0, 0, 0, 0, 0, 0, 0, 3, 50, 50 ],
      [ 0, 0, 0, 0, 0, 0, 0, 0, 0, 0, 0, 3, 50, 50 ],
      [ 0, 0, 0, 0, 0, 0, 0, 0, 0, 0, 0, 4, 50, 50 ],
      [ 0, 0, 0, 0, 0, 0, 0, 0, 0, 0, 0, 16, 50, 50 ],
      [ 0, 0, 0, 0, 0, 0, 0, 0, 0, 0, 1, 17, 50, 50 ],
      [ 0, 0, 0, 0, 0, 0, 0, 0, 0, 0, 0, 18, 50, 50 ],
      [ 0, 5, 21, 0, 0, 0, 0, 0, 0, 0, 0, 0, 50, 50 ],
      [ 0, 6, 22, 0, 0, 0, 0, 0, 0, 0, 0, 0, 50, 50 ],
      [ 0, 7, 23, 0, 0, 0, 0, 0, 0, 0, 0, 0, 0, 0 ],
      [ 0, 0, 0, 0, 0, 0, 0, 0, 0, 0, 0, 0, 0, 0 ],
      [ 0, 0, 0, 0, 0, 0, 0, 0, 0, 0, 0, 2, 50, 50 ],
      [ 0, 0, 0, 0, 0, 0, 0, 0, 0, 0, 0, 3, 50, 50 ],
      [ 0, 0, 0, 0, 0, 0, 0, 0, 0, 0, 0, 4, 50, 50 ],
      [ 0, 0, 0, 0, 0, 0, 0, 0, 0, 0, 0, 0, 50, 50 ],
      [ 0, 0, 5, 21, 0, 0, 0, 0, 0, 0, 0, 0, 50, 50 ],
      [ 0, 0, 6, 22, 0, 0, 0, 0, 0, 0, 0, 0, 50, 50 ],
      [ 0, 0, 6, 22, 0, 0, 0, 0, 33, 0, 0, 0, 50, 50 ],
      [ 0, 0, 6, 22, 0, 0, 0, 0, 35, 0, 0, 0, 50, 50 ],
      [ 0, 0, 7, 23, 0, 0, 0, 0, 33, 0, 0, 0, 50, 50 ],
      [ 0, 0, 0, 0, 33, 0, 0, 0, 0, 0, 0, 0, 50, 50 ],
      [ 0, 0, 0, 0, 33, 0, 0, 0, 0, 0, 0, 0, 50, 50 ],
      [ 0, 0, 0, 0, 33, 0, 0, 0, 0, 0, 0, 0, 50, 50 ],
      [ 0, 0, 0, 0, 33, 0, 0, 0, 0, 0, 0, 0, 50, 50 ],
      [ 0, 5, 21, 0, 33, 0, 0, 0, 0, 0, 0, 0, 50, 50 ],
      [ 0, 6, 22, 0, 33, 0, 0, 0, 0, 0, 0, 0, 50, 50 ],
      [ 0, 6, 22, 0, 33, 0, 0, 0, 0, 0, 0, 0, 0, 0 ],
      [ 0, 7, 23, 0, 33, 0, 0, 0, 0, 0, 0, 0, 0, 0 ],
      [ 0, 0, 0, 0, 0, 0, 0, 0, 0, 0, 0, 0, 0, 0 ],
      [ 0, 0, 0, 0, 0, 0, 0, 0, 0, 0, 0, 2, 50, 50 ],
      [ 0, 0, 0, 0, 0, 0, 0, 0, 0, 0, 0, 3, 50, 50 ],
      [ 0, 0, 0, 0, 33, 0, 0, 0, 0, 0, 0, 3, 50, 50 ],
      [ 0, 0, 0, 0, 33, 0, 0, 0, 0, 0, 0, 4, 50, 50 ],
      [ 0, 0, 0, 0, 33, 0, 0, 0, 0, 0, 0, 0, 50, 50 ],
      [ 0, 0, 0, 0, 35, 0, 0, 0, 33, 0, 0, 0, 50, 50 ],
      [ 0, 0, 0, 0, 0, 0, 0, 0, 0, 0, 0, 0, 50, 50 ],
      [ 0, 0, 0, 0, 0, 0, 0, 0, 0, 0, 0, 16, 50, 50 ],
      [ 0, 0, 0, 0, 0, 0, 0, 0, 0, 0, 16, 17, 50, 50 ],
      [ 0, 0, 0, 0, 0, 0, 0, 0, 0, 1, 17, 19, 50, 50 ],
      [ 0, 0, 0, 0, 0, 0, 0, 0, 0, 0, 18, 17, 50, 50 ],
      [ 0, 0, 0, 0, 0, 0, 0, 0, 33, 0, 0, 18, 50, 50 ],
      [ 0, 0, 0, 0, 0, 0, 0, 0, 33, 0, 0, 0, 50, 50 ],
      [ 0, 0, 0, 0, 0, 0, 0, 0, 0, 0, 0, 0, 50, 50 ],
      [ 0, 0, 0, 0, 0, 0, 0, 0, 0, 0, 0, 0, 50, 50 ],
      [ 0, 0, 5, 21, 0, 0, 0, 0, 0, 0, 0, 0, 50, 50 ],
      [ 0, 0, 6, 22, 0, 0, 0, 0, 0, 0, 0, 0, 50, 50 ],
      [ 0, 0, 7, 23, 0, 0, 0, 0, 35, 0, 0, 0, 50, 50 ],
      [ 0, 0, 0, 0, 0, 0, 0, 0, 0, 0, 0, 2, 50, 50 ],
      [ 0, 0, 0, 0, 0, 0, 0, 0, 0, 0, 0, 3, 50, 50 ],
      [ 0, 0, 0, 0, 35, 0, 0, 0, 35, 0, 0, 3, 50, 50 ],
      [ 0, 0, 0, 0, 0, 0, 0, 0, 0, 0, 0, 3, 50, 50 ],
      [ 0, 0, 0, 0, 0, 0, 0, 0, 0, 0, 0, 4, 50, 50 ],
      [ 0, 0, 0, 0, 0, 0, 0, 0, 35, 0, 0, 16, 50, 50 ],
      [ 0, 0, 0, 0, 0, 0, 0, 0, 0, 0, 1, 17, 50, 50 ],
      [ 0, 0, 0, 0, 0, 0, 0, 0, 0, 0, 0, 18, 50, 50 ],
      [ 0, 5, 21, 0, 0, 0, 0, 0, 0, 0, 0, 0, 50, 50 ],
      [ 0, 6, 22, 0, 0, 0, 0, 0, 0, 0, 0, 0, 50, 50 ],
      [ 0, 7, 23, 0, 0, 0, 0, 0, 0, 0, 0, 0, 50, 50 ],
      [ 0, 0, 0, 0, 0, 0, 0, 0, 33, 0, 0, 0, 50, 50 ],
      [ 0, 0, 0, 0, 0, 0, 0, 0, 0, 0, 0, 2, 50, 50 ],
      [ 0, 0, 0, 0, 0, 0, 0, 0, 0, 0, 0, 3, 50, 50 ],
      [ 0, 0, 0, 0, 33, 0, 0, 0, 0, 0, 0, 4, 50, 50 ],
      [ 0, 0, 0, 0, 33, 0, 0, 0, 0, 0, 0, 0, 50, 50 ],
      [ 0, 0, 5, 21, 33, 0, 0, 0, 0, 0, 0, 0, 50, 50 ],
      [ 0, 0, 6, 22, 0, 0, 0, 0, 0, 0, 0, 0, 50, 50 ],
      [ 0, 0, 6, 22, 0, 0, 0, 0, 0, 0, 0, 0, 50, 50 ],
      [ 0, 0, 6, 22, 0, 0, 0, 0, 0, 0, 0, 0, 50, 50 ],
      [ 0, 0, 7, 23, 0, 0, 0, 0, 0, 0, 0, 0, 50, 50 ],
      [ 0, 0, 0, 0, 33, 0, 0, 0, 0, 0, 0, 0, 50, 50 ],
      [ 0, 0, 0, 0, 35, 0, 0, 0, 33, 0, 0, 0, 50, 50 ],
      [ 0, 0, 0, 0, 35, 0, 0, 0, 33, 0, 0, 0, 50, 50 ],
      [ 0, 0, 0, 0, 33, 0, 0, 0, 0, 0, 0, 0, 50, 50 ],
      [ 0, 5, 21, 0, 0, 0, 0, 0, 0, 0, 0, 0, 50, 50 ],
      [ 0, 6, 22, 0, 0, 0, 0, 0, 0, 0, 0, 0, 50, 50 ],
      [ 0, 6, 22, 0, 0, 0, 0, 0, 0, 0, 0, 51, 50, 50 ],
      [ 0, 7, 23, 0, 0, 0, 0, 0, 0, 0, 51, 51, 50, 50 ],
      [ 0, 0, 0, 0, 0, 0, 0, 0, 0, 51, 51, 51, 50, 50 ],
      [ 0, 0, 0, 0, 0, 0, 0, 0, 51, 51, 51, 51, 50, 50 ],
      [ 0, 0, 0, 0, 0, 0, 0, 0, 0, 0, 0, 3, 50, 50 ],
      [ 0, 0, 0, 0, 0, 0, 0, 0, 0, 0, 0, 3, 50, 50 ],
      [ 0, 0, 0, 0, 0, 0, 0, 0, 51, 51, 51, 51, 50, 50 ],
      [ 0, 0, 0, 0, 0, 0, 0, 0, 0, 51, 51, 51, 50, 50 ],
      [ 0, 0, 0, 0, 0, 0, 0, 0, 0, 0, 51, 51, 50, 50 ],
      [ 0, 0, 0, 0, 0, 0, 0, 0, 0, 0, 0, 51, 50, 50 ],
      [ 0, 0, 0, 0, 0, 0, 0, 0, 0, 0, 0, 16, 50, 50 ],
      [ 0, 0, 0, 0, 0, 0, 0, 0, 0, 0, 16, 17, 50, 50 ],
      [ 0, 0, 0, 0, 0, 0, 0, 0, 0, 1, 17, 19, 50, 50 ],
      [ 0, 0, 0, 0, 0, 0, 0, 0, 0, 0, 18, 17, 50, 50 ],
      [ 0, 0, 0, 0, 0, 0, 0, 0, 0, 0, 0, 51, 50, 50 ],
      [ 0, 0, 0, 0, 0, 0, 0, 0, 0, 0, 51, 51, 50, 50 ],
      [ 0, 0, 0, 0, 0, 0, 0, 0, 0, 51, 51, 51, 50, 50 ],
      [ 0, 0, 0, 0, 0, 0, 0, 0, 51, 51, 51, 51, 50, 50 ],
      [ 0, 0, 5, 21, 0, 0, 0, 0, 51, 51, 51, 51, 50, 50 ],
      [ 0, 0, 6, 22, 0, 0, 0, 0, 0, 0, 0, 0, 0, 0 ],
      [ 0, 0, 7, 23, 0, 0, 0, 0, 0, 0, 0, 0, 0, 0 ],
      [ 0, 0, 0, 0, 0, 0, 0, 0, 51, 51, 51, 51, 50, 50 ],
      [ 0, 0, 0, 0, 0, 0, 0, 0, 0, 51, 51, 51, 50, 50 ],
      [ 0, 0, 0, 0, 0, 0, 0, 0, 0, 0, 51, 51, 50, 50 ],
      [ 0, 0, 0, 0, 0, 0, 0, 0, 0, 0, 0, 51, 50, 50 ],
      [ 0, 0, 0, 0, 0, 0, 0, 0, 0, 0, 0, 0, 50, 50 ],
      [ 0, 0, 0, 0, 0, 0, 0, 0, 0, 0, 0, 16, 50, 50 ],
      [ 0, 0, 0, 0, 0, 0, 0, 0, 0, 0, 1, 17, 50, 50 ],
      [ 0, 0, 0, 0, 0, 0, 0, 0, 0, 0, 0, 18, 50, 50 ],
      [ 0, 5, 21, 0, 0, 0, 0, 0, 0, 0, 36, 52, 50, 50 ],
      [ 0, 6, 22, 0, 0, 0, 0, 0, 0, 0, 37, 53, 50, 50 ],
      [ 0, 7, 23, 0, 0, 0, 0, 0, 0, 0, 0, 0, 50, 50 ],
      [ 0, 0, 0, 0, 0, 0, 0, 0, 0, 0, 0, 0, 50, 50 ],
      [ 0, 0, 0, 0, 0, 0, 0, 0, 0, 0, 0, 2, 50, 50 ],
      [ 0, 0, 0, 0, 0, 0, 0, 0, 33, 0, 0, 3, 50, 50 ],
      [ 0, 0, 0, 0, 0, 0, 0, 0, 33, 0, 0, 4, 50, 50 ],
      [ 0, 0, 0, 0, 0, 0, 0, 0, 35, 0, 0, 0, 50, 50 ],
      [ 0, 0, 5, 21, 0, 0, 0, 0, 33, 0, 0, 0, 50, 50 ],
      [ 0, 0, 6, 22, 0, 0, 0, 0, 0, 0, 0, 0, 50, 50 ],
      [ 0, 0, 6, 22, 0, 0, 0, 0, 0, 0, 0, 0, 50, 50 ],
      [ 0, 0, 6, 22, 0, 0, 0, 0, 0, 0, 0, 0, 50, 50 ],
      [ 0, 0, 7, 23, 0, 0, 0, 0, 0, 0, 0, 0, 50, 50 ],
      [ 0, 0, 0, 0, 0, 0, 0, 0, 0, 0, 0, 0, 50, 50 ],
      [ 0, 0, 0, 0, 0, 0, 0, 0, 0, 0, 0, 0, 50, 50 ],
      [ 0, 0, 0, 0, 0, 0, 0, 0, 0, 0, 0, 0, 50, 50 ],
      [ 0, 0, 0, 0, 0, 0, 0, 0, 0, 0, 36, 52, 50, 50 ],
      [ 0, 5, 21, 0, 0, 0, 0, 0, 0, 0, 37, 53, 50, 50 ],
      [ 0, 6, 22, 0, 0, 0, 0, 0, 0, 0, 0, 51, 50, 50 ],
      [ 0, 6, 22, 0, 0, 0, 0, 0, 0, 0, 51, 51, 50, 50 ],
      [ 0, 7, 23, 0, 0, 0, 0, 0, 0, 51, 51, 51, 50, 50 ],
      [ 0, 0, 0, 0, 0, 0, 0, 0, 51, 51, 51, 51, 50, 50 ],
      [ 0, 0, 0, 0, 0, 0, 0, 51, 51, 51, 51, 51, 50, 50 ],
      [ 0, 0, 0, 0, 0, 0, 51, 51, 51, 51, 51, 51, 50, 50 ],
      [ 0, 0, 0, 0, 0, 51, 51, 51, 51, 51, 51, 51, 50, 50 ],
      [ 0, 0, 0, 0, 51, 51, 51, 51, 51, 51, 51, 51, 50, 50 ],
      [ 0, 0, 0, 0, 51, 51, 51, 51, 51, 51, 51, 51, 50, 50 ],
      [ 0, 0, 0, 0, 51, 51, 51, 51, 51, 51, 51, 51, 50, 50 ],
      [ 0, 0, 0, 0, 0, 0, 0, 0, 0, 0, 0, 0, 50, 50 ],
      [ 0, 0, 0, 0, 0, 0, 0, 0, 0, 0, 0, 0, 50, 50 ],
      [ 0, 0, 0, 0, 0, 0, 0, 0, 0, 0, 0, 16, 50, 50 ],
      [ 0, 0, 0, 0, 0, 0, 0, 0, 0, 0, 16, 17, 50, 50 ],
      [ 0, 0, 0, 0, 0, 0, 0, 0, 0, 1, 17, 19, 50, 50 ],
      [ 0, 0, 0, 0, 0, 0, 0, 0, 0, 0, 18, 17, 50, 50 ],
      [ 0, 0, 0, 0, 0, 0, 0, 0, 0, 0, 0, 18, 50, 50 ],
      [ 0, 0, 26, 0, 0, 0, 0, 0, 0, 0, 0, 0, 50, 50 ],
      [ 0, 11, 27, 12, 28, 28, 28, 28, 28, 28, 28, 51, 50, 50 ],
      [ 0, 0, 0, 0, 0, 0, 0, 0, 0, 0, 0, 0, 50, 50 ],
      [ 0, 0, 5, 21, 0, 0, 0, 0, 0, 0, 0, 0, 50, 50 ],
      [ 0, 0, 6, 22, 0, 0, 0, 0, 0, 0, 0, 0, 50, 50 ],
      [ 0, 0, 7, 23, 0, 0, 0, 0, 0, 15, 13, 13, 50, 50 ],
      [ 0, 0, 0, 0, 0, 0, 0, 15, 29, 31, 13, 13, 50, 50 ],
      [ 0, 0, 0, 0, 0, 0, 0, 15, 13, 31, 14, 14, 50, 50 ],
      [ 0, 0, 0, 0, 0, 0, 0, 15, 30, 31, 13, 49, 50, 50 ],
      [ 0, 0, 0, 0, 0, 0, 0, 0, 0, 15, 13, 13, 50, 50 ],
      [ 0, 0, 0, 0, 0, 0, 0, 0, 0, 0, 0, 4, 50, 50 ],
      [ 0, 0, 0, 0, 0, 0, 0, 0, 0, 0, 0, 0, 50, 50 ],
      [ 0, 0, 0, 0, 0, 0, 0, 0, 0, 0, 0, 0, 50, 50 ],
      [ 0, 0, 0, 0, 0, 0, 0, 0, 0, 0, 0, 0, 50, 50 ],
      [ 0, 0, 0, 0, 0, 0, 0, 0, 0, 0, 0, 0, 50, 50 ],
      [ 0, 0, 0, 0, 0, 0, 0, 0, 0, 0, 0, 0, 50, 50 ],
      [ 0, 0, 0, 0, 0, 0, 0, 0, 0, 0, 0, 0, 50, 50 ],
      [ 0, 0, 0, 0, 0, 0, 0, 0, 0, 0, 0, 0, 50, 50 ],
      [ 0, 0, 0, 0, 0, 0, 0, 0, 0, 0, 0, 0, 50, 50 ],
      [ 0, 0, 0, 0, 0, 0, 0, 0, 0, 0, 0, 0, 50, 50 ],
      [ 0, 0, 0, 0, 0, 0, 0, 0, 0, 0, 0, 0, 50, 50 ],
      [ 0, 0, 0, 0, 0, 0, 0, 0, 0, 0, 0, 0, 50, 50 ],
      [ 0, 0, 0, 0, 0, 0, 0, 0, 0, 0, 0, 0, 50, 50 ],
      [ 0, 0, 0, 0, 0, 0, 0, 0, 0, 0, 0, 0, 50, 50 ],
      [ 0, 0, 0, 0, 0, 0, 0, 0, 0, 0, 0, 0, 50, 50 ],
      [ 0, 0, 0, 0, 0, 0, 0, 0, 0, 0, 0, 0, 50, 50 ]
    ]
  }
}
